好 的 谢谢 哦	不 客气 哦
哦 亲 : 我 买 那么 多 请 多 送 点试 吃零食 吧	您 拍 下 给 您 备注
什么 时候 发货 啊	在 的 客官
这个 质量 怎么样 这么 便宜	质量 不错 的 呢
没事	客官 帮 您 看 了 下 哦 牛肉干 属于 打 95 折 的 商品 哦 不 参与 买二送 一 活动 呢 实在 抱歉 呢 不过 小店 牛肉干 口味 很 不错 呢 客官 喜欢 的话 可以 拍下 哦
是 的 收藏 了	要 收藏 截图 哦
没有 啊	往下拉 拉 到 商品 详情页
提交 过 了 啊	稍 等
棉柔巾 怎么 好几种 啊 那种 好 呢	新生儿 的话 建议 纯棉 的
谢谢	不 客气 哦
已经 付款 了	好 的
我 知道 啊	恩恩
但是 现在 过 了 退货 时间 了 我 申请 售后 连 售后 都 过 时间 了	不用 申请 了 已经 过 了 售后 时间 直接 寄 回来
我 24 号 下单 的 现在 还 没 发货 怎么回事 要 到 什么 时候 发货	好 的 我们 会 尽快 发出 的 哦
擦 PP 专用 的 没有 吗	都 是 的
一码 归 一码	亲亲 因为 我们 之前 订单 量 多 所以 没 看清 实在 抱歉 亲亲 新年 第一天 也 不要 生气 了 下次 购买 的话 我们 绝对 不会 遗落 送亲 的 礼品 行 吗 亲亲 好平 返现 2 元 我们 返 您 5 元 然后 下次 买 的 时候 再 送亲 一包 巴旦 木加 其他 的 试吃 坚果 希望 亲 不要 不 开心 呢 我们 也 真的 很 抱歉
30 分中内 付款 是 指 拍 下 30 分钟 内 付款 而 不是 说 30 分前 就 结束 了	亲是 前 半小时 的 活动
这个 是不是 买一送一	一起 拍 下 自动 改价 哦 客官 此外 您 拍 下 宝贝 后 给 小二晒 下 关注 店铺 以及 添加 小店 微 信号 tealove2015 的 截图 小 二 这边 可以 给 您 申请 下送 您 点 试吃 小 礼品 哦
我 看到 更 合适 的 799 的 两组 我 得 再 退 一次	亲 可以 再 拍 哦 可以 的
你 个 大坏 坏	小二不坏 的 哦 小 二 很 可爱 的
OK 好 的	嗯 呢
那 就 给 我 纯白 的 吧	好 的 刚 得知 送 完 了 但是 答应 亲 了 我 还是 送 您 一套
是 的	好 的
哦	嗯 嗯 亲
这 三种 产品 能 送 两包 湿巾 和 两块 尿布 皂 是 吧 你 看 一下 人 呢	不送 的
明天 发 吗	明后天 新 到货 到货 后 帮 亲发 新货 哦
有 4 元 的 东西 吗 哪种 口味 好吃	个人 喜欢 奶油
好 那 我 先 试试看	嗯 嗯 好 的
明天 晚上 能 发出 来 吗	不 保证 的 呢 亲
对	今天 给 您 发货 哦
现在 下单 下午 能 发货 是 吧 是 发 邮政	亲爱 的 由于 年前 订单 量 较大 会 按照 亲亲 付款 订单 时间 顺序 3 - 5 天 左右 发货 哦 亲亲 耐心 等待 下 哦 我们 会 尽全力 将 宝贝 第一 时间 送达 您 的 手上 哦
刚有 好像 有单 不 小心 点到 收货 了 还有 单 的	嗯
收藏 送 什么	拍 2 组 收藏 送 2 包 湿巾 一组 没有 赠品
链接 给 我	您 要 什么 口味 的
520401029636	您好
本来 都 是 朋友 推荐 来 的	好 的 亲
本来 昨天 就 能 吃 到 的 物流 不好	下次 给 您 换个 快递 了 呢
这个 是 纯棉 的 吗 会 不会 掉 毛呢	纯棉 的 亲 不易 掉线 的 不易 掉 絮 打错
那就算了 吧 百世 可以	可以 的 您 直接 拍 下 订单 我 帮 您 备注
你好	恩恩有 什么 可以 帮 你 的
什么 时候 有 货	亲 不要 纸箱 的话 现在 有 货要 纸箱 的话 4 天 左右 有 货
对韵 达 快递	ok
那能 给 我 一个 解释 香味 什么 情况 拿 了 湿巾 的 手 一个 小时 还 能 一股 味	亲 觉得 不 满意 我们 支持 检测 的 呢 亲 可以 去 相关 部门 检测 呢
哦	恩恩
这个 金额 是否 达到 包邮 条件	您 提交 订单 帮 您 看 下
别跟我 说 这个 我 只 想 问 什么 时候 送	这边 只能 联系 下不送 我们 也 没 办法
好 吧	嗯 嗯
好	嗯 嗯 亲 请 核对 一下 收货 地址 哦
哦	嗯 嗯 亲
这个 一袋 多少 克	100g 哦
是 我 自己 的话 该 把 你 的 店拉黑 了	不好意思 呢
那 你 的 意思 是 最好 分开 两次 买 今天 先买 护理 垫 和 棉签	可以 的
是 的	好 的 客官 谢谢您 的 支持 哦 我们 会 尽快 给 您 发出 的 哦 希望 能 给 您 带来 不 一样 的 产品 真诚 期待 您 的 品尝 祝您 开心 每一秒 快乐 每 一天 幸福 每 一年 么 么 哒
应该 你们 联系 啊	恩恩 已经 留言 了 等 明天 快递 回复
生产日期 什么 时候 的	我 看 下 哦 57 日
对 的	好 的 呢
能 不能 送 两个 夹子	那 我 帮 您 申请 下 仓库 送 您 两个 吧
请 改 价格	好 了 亲亲 给 您 优惠 了 10 元 哦
更改 一下 价格 吧 亲	亲 还 没 下单 哦
为什么	套餐 有 多 一个 瓜子 哦
除了 EMS 没 别的 快递 吗	快递 随机 发 不 指定 的 呢
嗯 有 2020 的 纯棉 的 棉柔巾 么	稍 等 这款 纯棉 2020 哦
今天 买 好久 能 到	3 天 左右
嗯	现在 拍 下 今天 给 您 发出 的 哦
在家 比较 麻烦	产后 哺乳 胸部 就 会 变软 多少 会 有 下垂 的 情况 哺乳期 坚持 穿 哺乳 内衣
有没有 包装盒	有 的
放心 要是 真有 我会 拒收	好 的 现在 处理 退款
他 去 张家界 买 的 茶 我 不 知道 我 不 喝茶 反正 像 茶砖	那 建议 用大号 的 茶 刀 哦 比较 容易 撬
嗯	小二在 这 祝您 开心 每 一天 哦
哦 哦 明白 了 谢谢 老板	嗯 呢 客气 了
好 吧 行 的 那个 09 也 要 算 啊	亲 抹掉 了 哈 下次 生意
算了 我 618 再 拍 算了 你们 618 好像 也 是 那个 价	恩恩是 的 呢
好 的 哈	么 么 哒
好 吧	恩 呢
好 吧 我 怕 一直 拖 到时候 快递 不 收件 了	邮政 不停 的
这个 和 399 有 什么 区别	这 款 尺寸 大 一些 1520 的 另外 一款 1020 的
没关系 我发 快递 6 块钱 我 再 拍 你 再寄 你 也 花 邮费 你 又 不是 不 花钱 而且 你家 这样 没有 下次 生意 哦 我 明白 了 你家 520 的 活动 没写 618 是 新 写 的 不 等 618	对 的
两种 有 什么 区别	上面 的 无纺布 的 下面 的 纯棉 的 无纺布 和 纯棉 差不多 软 就 吸水 慢 一点 性价比 要 比 纯棉 的 要 高 很多 适合 大量 使用 无纺布 的 优点 易 展开
二合一 是	2 合一 是 茶针 和 养壶 笔 一体 哦 客官 茶刀 和 养壶 笔 一体 打 错 笔头 是 养壶 笔 中间 转 开来 是 茶 刀 哦
今天 付款 什么 时候 能 发货	24 会 陆续 发货 哦
45471763191	您好
然后 呢 我 要 小 的 又 不能 用 而且 这么 多包	非 质量 问题 退回 的 运费 亲自 理
好 的	嗯 嗯 亲
哦 我 拍 过 了 麻烦 亲 尽快 给 我 返现 和 发货	好 的 亲亲
内容 是 日用品 对 吧	用品
你好 这 一款 和 79 那个 有 什么 区别	这款 1020 的 尺寸
在 申请 一下 勾沙 确实 有点 严重	很 抱歉 帮不了 您 这个 是 我们 经理 说 的
嗯	好 的 恩
我 以前 也 买 过 这种 核桃 你家 比 他 便宜 几块钱 东西 是 一样 的 吗	牌子 一模一样 的
好 吧 马上 下单 早点 帮 我 发货 要 发好 一点 奥 回来 给 你 好评 已付 好 早点 帮 我 发奥	下单 3 - 5 天 发货 亲
嗯 那 我 先买 两个	好 的 呢
第一次 买 希望 不要 失望	好 的
等会 问到 其他 地址 了 还要 拍	好 的 呢 好 的 客官 谢谢您 的 支持 哦 我们 会 尽快 给 您 发出 的 哦 希望 能 给 您 带来 不 一样 的 产品 真诚 期待 您 的 品尝 祝您 开心 每一秒 快乐 每 一天 幸福 每 一年 么 么 哒
我 看看 哦 能 用点 别的 给 我 试吃 一下 吗 送	可以 的 客官 想要 什么 呢
不能 买	亲 稍 等 我 问下
527658979000 这个 呢	无纺布 的 这款
我 明天 早上 十点 要 上课	好 的 吧 亲
好评 那 是 必须 的	谢谢 亲
有 朋友 买 说 每支 68 元	上千 吧 可以 的
我 在 找 找	而且 目前 天气炎热 核桃 运输 中 容易 出油 哦 客官 要是 预定 九月份 的 新货 的话 咱 这里 可以 给 您 改价 85 的 哦
要是 我 走 了 那 我 就 拒收 可以 吗 亲	可以 的
请问 怎么 预付 呢 页面 没找 见	亲拍 哪 一款 呢
