[bdt.ci.cli]
base-build = bob.devtools.scripts.ci:base_build
base-deploy = bob.devtools.scripts.ci:base_deploy
build = bob.devtools.scripts.ci:build
clean = bob.devtools.scripts.ci:clean
deploy = bob.devtools.scripts.ci:deploy
docs = bob.devtools.scripts.ci:docs
nightlies = bob.devtools.scripts.ci:nightlies
pypi = bob.devtools.scripts.ci:pypi
readme = bob.devtools.scripts.ci:readme
test = bob.devtools.scripts.ci:test

[bdt.cli]
build = bob.devtools.scripts.build:build
caupdate = bob.devtools.scripts.caupdate:caupdate
ci = bob.devtools.scripts.ci:ci
create = bob.devtools.scripts.create:create
dumpsphinx = bob.devtools.scripts.dumpsphinx:dumpsphinx
gitlab = bob.devtools.scripts.gitlab:gitlab
new = bob.devtools.scripts.new:new
rebuild = bob.devtools.scripts.rebuild:rebuild
test = bob.devtools.scripts.test:test

[bdt.gitlab.cli]
changelog = bob.devtools.scripts.changelog:changelog
commitfile = bob.devtools.scripts.commitfile:commitfile
getpath = bob.devtools.scripts.getpath:getpath
jobs = bob.devtools.scripts.jobs:jobs
lasttag = bob.devtools.scripts.lasttag:lasttag
release = bob.devtools.scripts.release:release
runners = bob.devtools.scripts.runners:runners
visibility = bob.devtools.scripts.visibility:visibility

[console_scripts]
bdt = bob.devtools.scripts.bdt:main

